15 17
*****************
*               *
* ****** ****** *
* *    * *    * *
*               *
* *    * *    * *
* ****** ****** *
*      ***      *
* ****** ****** *
* *    * *    * *
*               *
* *    * *    * *
* ****** ****** *
*    O          *
*****************
P 1 6

