16 17
*****************
*               *
* ****** ****** *
* *    * *    * *
*               *
* *    * *    * *
* ****** ****** *
*               *
* ****** ****** *
* *    * *    * *
*               *
* *    * *    * *
* ****** ****** *
*               *
*              O*
*****************
P 1 2

