15 17
*****************
*      @    @   *
* ****** ****** *
* *    * *    * *
*               *
* *    * *    * *
* ****** ****** *
*  @         @  *
* ****** ****** *
* *    * *    * *
*   @         @ *
* *    * *    * *
* ****** ****** *
*    @         O*
*****************
P 1 1
F 7 1
F 1 8

